NO ./images/metal352.png
SO ./images/metal351.png
WE ./images/metal354.png
EA ./images/metal353.png

F 220,100,0
C 0,255,255

1111111111111111
