NO ./images/bigcat1.png
SO ./images/bigcat2.png
WE ./images/bigcat3.png
EA ./images/bigcat4.png

F 0,100,0
C 0,255,255

           11111111111111111111
           10000000000000000001
           10000011100W00011001
           11111001100010011101
           10011011000111011001
1111111111110000000000000000001
1011000001100011100111111111111
10111110111110100001           
10110010000000001111
10000000110000000001
11111111111111111111
