NO ./images/metal352.png
SO ./images/metal351.png
WE ./images/metal354.png
EA ./images/metal353.png

F 220,100,0
C 0,255,255

11111111111111111111
10000000000000000001
10000000000000000001
10000000000000000001
10000000000000000001        1111
10000000000000000001        11N1
10000000000000000001        1111
1000011111000000000111
100001   1000000000001
100001   1000000000001
111111111111111111111
