NO ./images/bigcat1.png
SO ./images/bigcat2.png
WE ./images/bigcat3.png
EA ./images/bigcat4.png

F 0,100,0
C 0,255,255

11111111111111111111
10000000000000000001
10000011100S00011001
11111001100010011111
10011011000111111001
10000000000000000001
10110000011000111001
10111110111111101001
10110010000000001111
10000000110000000001
11111111111111111111
