NO ./images/metal352.png
SO ./images/metal351.png
WE ./images/metal354.png
EA ./images/metal353.png

F 200,223,111
C 0,255,255

11111111111111111111
10000000000000000001
10000011000000011001
11111001000010011111
10011111000011111001
100000000N0000000001
10110000000000111001
10111111111111101001
10110010000000001111
10000000110000000001
11111111111111111111
