11111111111111111111
10000000000000000001
10000000000000000001
11111000000000011111
10011000000000011001
100000000N0000000001
10000000000000000001
10110000000000011001
10110000000000011001
10000000000000000001
11111111111111111111