NO ./images/metal1.png
SO ./images/metal2.png
WE ./images/metal3.png
EA ./images/metal4.png

F 75,46,30
C 47,47,47

11111111111111111111
10000000000000000001
10001000000011D10001
10111D11000010011111
101110000N00D0011001
10100001D10011110001
10000001D10000000001
10110000001100111001
10111110011100011001
10000000000000000001
11111111111111111111
