11111111111111111111
10000000000000000001
10001000000011D10001
10111D11000010011111
101110000000D0011001
101000000W0011110001
10000000000000000001
10110000001100111001
10111110011100011001
10000000000000000001
11111111111111111111