NO ./images/metal352.png
SO ./images/metal351.png
WE ./images/metal354.png
EA ./images/metal353.png

F 200,223,111
C 0,255,255

11111111111111111111
10000000000000000001
10001000N00011D10001
10111D11000010011111
101110000000D0011001
10100001D10011110001
10000001D10000000001
10110000001100111001
10111110011100011001
10000000000000000001
11111111111111111111
