111111111111111111111111111111111111111111
100000000110000111110110000111110110011111
111111110100000111110100000111110100011111
111111110100000111110100000111110100011111
111111110000000111110000000111110000011111
111111111110100111111110000111111110011111
111111111110100111111110000111111110011111
111000000000000000000000000000000000010001
111011111000100011111000000011111000010111
111011111000100011111000000001111100001011
111111111110100111111110000011111110010111
11101000E000100010000000000010000000010101
11000000000000000000000000000000W000000001
110111111110000111111110000111111110001111
111111111111111111111111111111111111111111