NO ./images/metal1.png
SO ./images/metal2.png
WE ./images/metal3.png
EA ./images/metal4.png

F 75,46,30
C 47,47,47


111111111111111111111111111111111111111111
10000000011000011000011000000D000000000011
10011011D10000011011010000011111D100011011
100110110100010000110100000111110100011011
11D11D11000001011D110000000D00000000011D11
11011011111011011011111000011111111D111011
110000000010011110111000011111111000110011
111111111D10000000000000000000000000010001
        100010111000100011111000000011101111111111
        1110101110001000D00000000N00011D1100011011
        11101011111D100111111110000011101110010011
        111010000000100010000D00000010000011D10101
        110000011000000000001111000000000000000001
        110110011110000111111110000111111110001111
        111111111111111111111111111111111111111111