NO ./images/metal352.png
SO ./images/metal351.png
WE ./images/metal354.png
EA ./images/metal353.png

F 220,100,0
C 0,255,255


111111111111111111111111111111111111111111
10000000011000011000011000000D000000000011
10011011D10000011011010000011111D100011011
100110110100010000110100000111110100011011
11D11D11000001011D110000000D00000000011D11
11011011111011011011111000011111111D111011
110000000010011110111000011111111000110011
111111111D10000000000000000000000000010001
        100010111000100011111000000011101111111111
        1110101110001000D00000000000011D1100011011
        11101011111D100111111110000011101110010011
        111010000000100010000D00000010000011D10101
        110000011000000000001111000000E00000000001
        110110011110000111111110000111111110001111
        111111111111111111111111111111111111111111